-1 -1 -1 -1 -1 -1 -1 -1 -1 -1 -1 -1 -1 -1 -1 -1 -1 -1 -1 -1 -1 -1 -1 -1 -1 -1 -1 -1 -1 -1 -1 -1
-1 -1 -1 -1 -1 -1 -1 -1 -1 -1 -1 -1 -1 -1 -1 -1 -1 -1 -1 -1 -1 -1 -1 -1 -1 -1 -1 -1 -1 -1 -1 -1
-1 -1 -1 -1 -1 -1 -1 -1 -1 -1 -1 -1 -1 -1 -1 -1 -1 -1 -1 -1 -1 -1 -1 -1 -1 -1 -1 -1 286 -1 -1 -1
-1 -1 -1 -1 -1 -1 -1 -1 -1 -1 -1 -1 -1 -1 -1 -1 -1 -1 -1 -1 -1 -1 -1 -1 -1 286 -1 -1 286 286 286 -1
-1 -1 -1 -1 -1 -1 -1 -1 -1 -1 -1 -1 -1 -1 -1 -1 -1 -1 -1 -1 -1 -1 -1 -1 -1 286 -1 286 286 -1 -1 -1
-1 -1 -1 -1 -1 -1 -1 -1 -1 -1 -1 -1 -1 -1 -1 -1 286 286 286 286 -1 -1 -1 -1 -1 -1 -1 286 -1 -1 -1 -1
-1 -1 -1 -1 -1 -1 -1 286 286 286 286 286 286 286 286 286 286 286 286 286 286 286 -1 -1 -1 -1 -1 -1 -1 -1 -1 -1
-1 -1 -1 -1 -1 -1 286 286 286 286 286 286 286 286 286 286 286 286 286 286 286 286 -1 -1 -1 -1 -1 -1 -1 -1 -1 -1
-1 -1 -1 -1 -1 -1 286 286 286 286 286 286 286 286 286 286 286 286 286 286 286 286 286 286 -1 -1 -1 -1 -1 -1 -1 -1
-1 -1 -1 -1 286 286 286 286 286 286 286 286 286 286 286 286 286 286 286 286 286 286 286 286 -1 -1 -1 -1 -1 -1 -1 -1
-1 -1 -1 286 286 286 286 286 286 286 286 286 286 286 286 286 286 286 286 286 286 286 286 286 286 286 -1 -1 -1 -1 -1 -1
-1 -1 -1 286 286 286 286 286 286 286 286 286 286 286 286 286 286 286 286 286 286 286 286 286 286 286 286 -1 -1 -1 -1 -1
-1 -1 -1 286 286 -1 286 286 286 286 286 286 286 286 286 286 286 286 286 286 286 286 286 286 286 286 286 286 -1 -1 -1 -1
-1 -1 -1 286 286 286 286 286 286 286 286 286 286 286 286 286 286 286 286 286 286 286 286 286 286 286 286 286 -1 -1 -1 -1
-1 -1 -1 -1 286 286 286 286 286 286 286 286 286 286 286 286 286 286 286 286 286 286 286 286 286 286 286 286 286 -1 -1 -1
-1 -1 -1 286 286 286 286 286 286 286 286 286 286 286 286 286 286 286 286 286 286 286 286 286 286 286 286 286 286 -1 -1 -1
-1 -1 -1 -1 286 286 286 286 286 286 286 286 286 286 286 286 286 286 286 286 286 286 286 286 286 286 286 286 286 286 -1 -1
-1 -1 -1 -1 -1 286 286 286 286 286 286 286 286 286 286 286 286 286 286 286 286 286 286 286 286 286 286 286 286 286 -1 -1
-1 -1 -1 -1 -1 286 286 286 286 286 286 286 286 286 286 286 286 286 286 286 286 286 286 286 286 286 286 286 286 -1 -1 -1
-1 -1 -1 -1 -1 286 286 286 286 286 286 286 286 286 286 286 286 286 286 286 286 286 286 286 286 286 286 286 286 286 -1 -1
-1 -1 -1 -1 -1 -1 286 286 286 286 286 286 286 286 286 286 286 286 286 286 286 286 286 286 286 286 286 286 286 -1 -1 -1
-1 -1 -1 -1 -1 -1 -1 -1 286 286 286 286 286 286 286 286 286 286 286 286 286 286 286 286 286 286 286 286 286 -1 -1 -1
-1 -1 -1 -1 -1 -1 -1 -1 286 286 286 286 286 286 286 286 286 286 286 286 286 286 286 286 286 286 286 286 -1 -1 -1 -1
-1 -1 -1 -1 -1 -1 -1 -1 -1 -1 286 286 286 286 286 286 286 286 286 286 286 286 286 286 286 286 286 -1 -1 -1 -1 -1
-1 -1 -1 -1 -1 -1 -1 -1 -1 -1 -1 -1 286 -1 286 286 286 286 286 286 286 286 286 286 286 286 -1 -1 -1 -1 -1 -1
-1 -1 -1 -1 -1 -1 -1 -1 -1 -1 -1 -1 -1 -1 -1 -1 286 286 286 286 286 286 286 286 286 286 -1 -1 -1 -1 -1 -1
-1 -1 -1 -1 -1 -1 -1 -1 286 286 -1 -1 -1 -1 -1 -1 -1 -1 -1 -1 286 -1 286 286 286 286 -1 -1 -1 -1 -1 -1
-1 -1 -1 -1 -1 -1 -1 286 -1 -1 286 -1 -1 -1 -1 -1 -1 -1 -1 -1 -1 -1 -1 286 -1 -1 -1 -1 -1 -1 -1 -1
-1 -1 -1 -1 -1 -1 -1 286 -1 -1 286 -1 -1 -1 -1 -1 -1 -1 -1 -1 -1 -1 -1 286 -1 -1 -1 -1 -1 -1 -1 -1
-1 -1 -1 -1 -1 -1 -1 286 286 286 -1 -1 -1 -1 -1 -1 -1 -1 -1 -1 -1 -1 -1 286 -1 -1 -1 -1 -1 -1 -1 -1
-1 -1 -1 -1 -1 -1 -1 -1 -1 -1 -1 -1 -1 -1 -1 -1 -1 -1 -1 -1 -1 -1 -1 -1 -1 -1 -1 -1 -1 -1 -1 -1
-1 -1 -1 -1 -1 -1 -1 -1 -1 -1 -1 -1 -1 -1 -1 -1 -1 -1 -1 -1 -1 -1 -1 -1 -1 -1 -1 -1 -1 -1 -1 -1
