144,144,144,144,144,144,144,144,144,144,144,144,144,144,144,144,144,144,144,144,144,144,144,144,144,144,144,144,144,144,144,144
144,144,144,144,144,144,144,144,144,144,144,144,144,144,144,144,144,144,144,144,144,144,144,144,121,170,170,174,170,170,122,144
144,144,144,144,144,144,144,144,144,144,144,144,144,144,144,144,144,144,144,144,144,144,144,144,145,131,131,223,131,131,143,144
144,144,144,144,144,144,144,144,144,144,144,144,144,144,144,144,144,144,144,144,144,144,144,144,145,131,127,255,78,80,143,144
144,144,144,144,144,121,170,170,170,170,170,170,170,170,170,170,170,170,170,170,170,122,144,144,145,131,225,131,131,131,143,144
144,144,144,144,121,171,131,131,131,131,131,131,131,131,131,131,131,131,131,131,131,169,122,144,147,118,152,131,117,118,148,144
144,144,144,144,145,131,131,131,131,131,131,131,131,131,131,131,131,131,131,131,131,131,143,144,144,144,147,118,148,144,144,144
144,144,144,144,145,131,131,131,131,131,131,131,131,131,131,131,131,131,131,131,131,131,169,170,122,144,144,144,144,144,144,144
144,144,144,121,171,131,131,131,131,131,16,131,131,131,131,131,16,131,131,131,131,131,131,131,169,122,144,144,144,144,144,144
144,144,121,171,131,131,131,131,131,91,71,14,15,131,13,14,48,131,131,131,131,131,131,131,131,169,122,144,144,144,144,144
144,144,145,131,131,131,131,131,131,131,39,27,43,1,44,17,67,131,131,131,131,131,131,131,131,131,169,122,144,144,144,144
144,144,145,131,131,131,131,131,131,131,39,27,27,27,17,67,131,131,131,131,131,131,131,131,131,131,131,169,122,144,144,144
144,144,145,131,131,131,131,131,131,131,39,27,27,17,67,131,131,131,131,131,131,131,131,131,131,131,131,131,143,144,144,144
144,144,145,131,131,131,131,131,131,131,65,18,27,41,131,131,131,16,131,131,131,131,131,131,131,131,131,131,169,122,144,144
144,144,145,131,131,131,131,131,131,131,131,39,27,41,131,131,91,77,131,131,131,131,131,131,131,131,131,131,131,143,144,144
144,144,145,131,131,131,131,131,131,131,131,39,17,67,131,131,131,131,131,131,131,131,131,131,131,131,131,131,131,169,144,144
144,144,147,119,131,131,131,131,131,91,74,19,67,131,131,94,131,131,131,131,13,14,14,14,15,131,131,131,131,131,143,144
144,144,144,147,119,131,131,131,131,131,65,67,131,131,131,131,131,131,131,131,39,27,27,27,43,15,131,131,131,131,143,144
144,144,144,144,145,131,131,131,131,131,131,131,131,131,131,131,131,131,131,131,65,66,18,27,27,41,131,131,131,131,143,144
144,144,144,144,145,131,131,131,131,131,131,131,131,131,131,131,131,131,131,131,131,131,65,18,27,46,93,131,131,131,143,144
144,144,144,144,147,119,131,131,131,131,131,131,131,131,131,131,131,16,131,131,131,131,131,65,66,67,131,131,131,117,148,144
144,144,144,144,144,147,119,131,131,131,131,131,131,131,131,131,131,75,25,131,131,131,131,131,131,131,131,131,131,143,144,144
144,144,144,144,144,144,147,119,131,131,131,131,131,131,131,131,131,131,75,93,131,131,131,131,131,131,131,131,117,148,144,144
144,144,144,144,144,144,144,147,118,119,131,131,131,131,131,131,131,131,131,131,94,131,131,131,131,131,131,117,148,144,144,144
144,144,144,144,144,144,144,144,144,147,118,119,131,131,131,131,131,131,131,131,131,131,131,131,131,131,117,148,144,144,144,144
144,144,144,144,144,144,144,121,170,170,122,147,118,118,118,119,131,131,131,131,131,131,131,16,131,131,143,144,144,144,144,144
144,144,144,144,144,144,121,171,131,131,169,122,144,144,144,147,118,118,118,119,131,131,91,51,131,131,143,144,144,144,144,144
144,144,144,144,144,144,145,131,131,131,131,143,144,144,144,144,144,144,144,147,118,119,131,68,131,117,148,144,144,144,144,144
144,144,144,144,144,144,145,131,131,131,131,143,144,144,144,144,144,144,144,144,144,147,118,118,118,148,144,144,144,144,144,144
144,144,144,144,144,144,145,131,131,131,117,148,144,144,144,144,144,144,144,144,144,144,144,144,144,144,144,144,144,144,144,144
144,144,144,144,144,144,147,118,118,118,148,144,144,144,144,144,144,144,144,144,144,144,144,144,144,144,144,144,144,144,144,144
144,144,144,144,144,144,144,144,144,144,144,144,144,144,144,144,144,144,144,144,144,144,144,144,144,144,144,144,144,144,144,144
