27 27 27 27 27 27 27 27 27 27 27 27 27 27 27 27 27 27 27 27
27 131 131 131 131 131 131 131 131 131 131 131 131 131 131 131 131 131 131 27
27 131 131 131 131 131 131 131 131 131 131 131 131 131 131 131 131 131 131 27
27 131 131 27 131 131 27 131 27 131 131 27 131 131 131 27 131 131 131 27
27 131 131 131 131 131 131 131 131 131 131 131 131 131 27 131 27 131 131 27
27 131 131 131 131 131 131 131 131 131 131 27 131 131 131 131 131 131 131 27
27 131 131 27 27 27 131 131 131 131 131 131 131 131 131 131 131 131 131 27
27 131 131 27 131 27 131 131 131 131 131 131 131 131 27 131 27 131 131 27
27 131 131 27 27 27 131 131 131 131 131 131 131 131 27 131 27 131 131 27
27 131 131 131 131 131 131 131 27 27 27 131 131 131 27 131 27 131 131 27
27 131 131 131 131 131 131 131 27 27 27 131 131 131 27 131 27 131 131 27
27 131 131 131 131 131 131 131 27 27 27 131 131 131 27 131 27 131 131 27
27 27 131 131 131 131 131 131 131 131 131 131 131 131 131 131 131 131 131 27
27 27 27 131 131 131 131 131 131 131 131 131 131 131 131 131 131 131 131 27
27 131 27 27 131 131 131 131 131 131 131 131 27 27 27 27 27 131 131 27
27 131 131 27 27 131 131 131 131 131 131 131 131 131 131 131 131 131 131 27
27 131 131 131 27 27 131 131 131 131 131 131 27 27 27 27 27 131 131 27
27 131 131 131 131 27 27 131 131 131 131 131 131 131 131 131 131 131 131 27
27 131 131 131 131 131 27 27 131 131 131 131 131 131 131 131 131 131 131 27
27 27 27 27 27 27 27 27 27 27 27 27 27 27 27 27 27 27 27 27
