144 144 144 144 144 144 144 144 144 144 144 144 144 144 144 144 144 144 144 144 144 144 144 144 144 144 144
144 144 144 144 144 144 144 144 144 144 144 144 144 144 144 144 144 144 144 144 144 144 144 144 144 144 144
144 144 144 144 144 144 144 144 144 144 144 144 144 144 144 144 144 144 144 144 144 144 144 144 144 144 144
144 144 144 144 144 144 144 144 144 144 144 144 144 144 144 144 144 144 144 144 144 144 144 144 144 144 144
144 144 144 144 144 121 170 170 170 170 170 170 170 170 170 170 170 170 170 170 170 122 144 144 144 144 144
144 144 144 144 121 171 131 131 131 131 131 131 131 131 131 131 131 131 131 131 131 169 122 144 144 144 144
144 144 144 144 145 131 131 131 131 131 131 131 131 131 131 131 131 131 131 131 131 131 143 144 144 144 144
144 144 144 144 145 131 131 131 131 131 131 131 131 131 131 131 131 131 131 131 131 131 143 144 144 144 144
144 144 144 144 145 131 131 131 131 131 3 131 131 131 131 131 3 131 131 131 131 131 143 144 144 144 144
144 144 144 144 145 131 131 131 131 78 58 1 2 131 0 1 35 131 131 131 131 131 143 144 144 144 144
144 144 144 144 145 131 131 131 131 131 26 27 30 1 31 4 54 131 131 131 131 131 143 144 144 144 144
144 144 144 144 145 131 131 131 131 131 26 27 27 27 4 54 131 131 131 131 131 131 143 144 144 144 144
144 144 144 144 145 131 131 131 131 131 26 27 27 4 54 131 131 131 131 131 131 131 143 144 144 144 144
144 144 144 144 145 131 131 131 131 131 52 5 27 28 131 131 131 3 131 131 131 131 143 144 144 144 144
144 144 144 144 145 131 131 131 131 131 131 26 27 28 131 131 78 64 131 131 131 131 143 144 144 144 144
144 144 144 144 145 131 131 131 131 131 131 26 4 54 131 131 131 131 131 131 131 131 143 144 144 144 144
144 144 144 144 145 131 131 131 131 78 61 6 54 131 131 81 131 131 131 131 131 131 143 144 144 144 144
144 144 144 144 145 131 131 131 131 131 52 54 131 131 131 131 131 131 131 131 131 131 143 144 144 144 144
144 144 144 144 145 131 131 131 131 131 131 131 131 131 131 131 131 131 131 131 131 131 143 144 144 144 144
144 144 144 144 145 131 131 131 131 131 131 131 131 131 131 131 131 131 131 131 131 131 143 144 144 144 144
144 144 144 144 147 119 131 131 131 131 131 131 131 131 131 131 131 131 131 131 131 117 148 144 144 144 144
144 144 144 144 144 147 118 118 118 118 118 118 118 118 118 118 118 118 118 118 118 148 144 144 144 144 144
144 144 144 144 144 144 144 144 144 144 144 144 144 144 144 144 144 144 144 144 144 144 144 144 144 144 144
144 144 144 144 144 144 144 144 144 144 144 144 144 144 144 144 144 144 144 144 144 144 144 144 144 144 144
144 144 144 144 144 144 144 144 144 144 144 144 144 144 144 144 144 144 144 144 144 144 144 144 144 144 144
144 144 144 144 144 144 144 144 144 144 144 144 144 144 144 144 144 144 144 144 144 144 144 144 144 144 144